MMMMMMMMMMMM
BGGGGGGGGGGM
MGGGGGGGGGGM
MGGGGGGGGGGM
MGGGGGGGPGGM
MGGGGGGGGGGM
MGGGGGGGGGGM
MGGGGHGGGGGM
MGGGGGGGGGGM
MGGGGPGGGGGM
MGGGGGGGGGGM
MMMMMMMMMMMM