MMMMMMMMMMMM
BGGGGGGGGGGM
MGGGGGGGGGGM
MGGGGGGGGGGM
MGGGGGGGGGGM
MGGGGGGGGGGM
MGGGGGGGGGGM
MGGGGVGGGGGM
MGGGGGGGPGGM
MGGGGGGGGGGM
MPGGGGGGGGGM
MMMMMMMMMMMM