MMMMMMMMMMMM
BGGGGGGGGGGM
MTTTTTGTTTTM
MGGGGGGGHGGM
MGGGGGGGGGGM
MGGGGGGGPGGM
MGTTTTTTTTTM
MGHGGGGGGGGM
MGGGGGGGGGGM
MGGGGPGGGGGM
MGGGGGGGGGGM
MMMMMMMMMMMM