MMMMMMMMMMMM
BGGGGGGTGGGM
MGGGGGGTGGGM
MGGGGGGTGGGM
MGGGGGGTPGGM
MGGGGGGTGGGM
MGGGGGGGGGGM
MGGGGVGTGGGM
MGGGGGGTPGGM
MGGGGGGTGGGM
MGGGGGGTGGGM
MMMMMMMMMMMM