MMMMMMMMMMMM
BGGGGGGGGGGM
MGGGGGGGGGGM
MGGGGGGGGGGM
MGGGGGGGGGGM
MGGGGGGGGGGM
MTTTTTTTTTGM
MGGGGHGGGGGM
MPGGGGGGPGGM
MGGGGGGGGGGM
MGGGGGGGGGGM
MMMMMMMMMMMM