MMMMMMMMMMMM
BGGGGGGGGGGM
MGGGGGGGGGGM
MGGGGGGGGGGM
MGGGGGGGGGGM
MTTGPTTTTTGM
MGGGGGGGHGGM
MGGGTGGGGGGM
MGGGTGGTTGGM
MGGVPGGTPGGM
MGGGTGGGGGGM
MMMMMMMMMMMM