MMMMMMMMMMMM
BGGVGGGGGGGM
MGTGTTTTGTGM
MGTGTGGGGTGM
MGTGPGGGGTGM
MGTGTGGGGGGM
MGTGPGGGGTGM
MGTGTGGGGTGM
MGTGPGGGGGGM
MGTGTGGGGTGM
MGGGGGGGVTPM
MMMMMMMMMMMM