MMMMMMMMMMMM
BGGGGGGGGGGM
MGGGTTGTPTGM
MHGGGGGGGGGM
MGGTTTGTPTGM
MHGGGGGGGGGM
MGTTTGVTPTGM
MHGGGGGGGGGM
MTTTGGGTPTGM
MGGGGGHGGGGM
MGGGGGGTPTVM
MMMMMMMMMMMM