MMMMMMMMMMMM
BGGGGGGGGGGM
MGGGGGGGGGGM
MGGGGGGGHGGM
MTTTTTTTTTPM
MGGGGGGGGGGM
MPTTTTTTTTTM
MGHGGGGGGGGM
MGGGGGGGGGGM
MGGGGPGGGGGM
MGGGGGGGGGGM
MMMMMMMMMMMM