MMMMMMMMMMMM
BGGGGGGGGGGM
MTGTTGTTGGGM
MGGGGGGGGGPM
MGGTGGGGGGGM
MGGTTGTTTTTM
MGGGGGGGGGGM
MGGTGVGGGGGM
MTGTTGGTPGGM
MGGGGGGGGGGM
MGVGPGGGGGGM
MMMMMMMMMMMM